1111111111111111
1000100001E10001
1C00100001011111
100000P000010001
1001000100010001
100100C100C10C01
1111111111111111
