1111111111111111111111111111111111
1000000000000000000000000000000001
1000P00000000000000000000000000001
1000000000001111111111000000000001
1000000000001        1000000000001
1000000000001        1000000000001
1000000000001        1000000000001
1000000000001        1000000000001
1000CC00000011111111110000000C0001
1000000000000000000000000000000001
1000000000000000000000000000000001
1111111111111111111111111111111111