111111111111
100010000101
100010000101
100000P00001
100100010001
10E100010001
111111111111
