111111111111
1000100001E1
10C010000101
100000P00001
100100010001
10P100C100C1
111111111111
