1111111
1000001
1P00CE0
1000001
1111111
