111111
1010C1
101001
100101
100001
1C1011
1001C1
100001
101001
1000C1
1PE101
111111