1111111111111111
11100000100000C1
1100010000011111
1C000100C0000111
1000000011111111
1100110000100001
10001100C0000111
1000000010000001
1110010011110001
1000010010000001
1C0011PE100000C1
1111111111111111